[
  {
    "level": "debug",
    "clearingScore": 4,
    "map": [
      [0, 0, 0, 0, 0, 0, 3, 3, 3],
      [0, 2, 0, 4, 0, 0, 0, 0, 3],
      [0, 0, 0, 0, 0, 0, 0, 0, 3],
      [0, 0, 0, 0, 0, 2, 4, 0, 0],
      [0, 4, 0, 2, 0, 0, 0, 1, 0],
      [0, 0, 0, 0, 0, 0, 0, 0, 0],
      [0, 0, 0, 0, 4, 0, 0, 0, 3],
      [0, 0, 0, 0, 0, 0, 3, 3, 3],
      [0, 0, 0, 0, 2, 0, 0, 0, 0]
    ]
  },
  {
    "level": "1",
    "clearingScore": 4,
    "map": [
      [0, 0, 3, 3, 3, 0, 0, 0, 0],
      [0, 0, 3, 4, 3, 0, 0, 0, 0],
      [0, 0, 3, 0, 3, 3, 3, 3, 0],
      [3, 3, 3, 2, 0, 2, 4, 3, 0],
      [3, 4, 0, 2, 1, 3, 3, 3, 0],
      [3, 3, 3, 3, 2, 3, 0, 0, 0],
      [0, 0, 0, 3, 4, 3, 0, 0, 0],
      [0, 0, 0, 3, 3, 3, 0, 0, 0],
      [0, 0, 0, 0, 0, 0, 0, 0, 0]
    ]
  },
  {
    "level": "2",
    "clearingScore": 3,
    "map": [
      [3, 3, 3, 3, 3, 0, 0, 0, 0],
      [3, 0, 0, 1, 3, 0, 0, 0, 0],
      [3, 0, 2, 2, 3, 0, 3, 3, 3],
      [3, 0, 2, 0, 3, 0, 3, 4, 3],
      [3, 3, 3, 0, 3, 3, 3, 4, 3],
      [0, 3, 3, 0, 0, 0, 0, 4, 3],
      [0, 3, 0, 0, 0, 3, 0, 0, 3],
      [0, 3, 0, 0, 0, 3, 3, 3, 3],
      [0, 3, 3, 3, 3, 3, 0, 0, 0]
    ]
  }
]
